###S#################
#                   #
######### # ####### #
#   #     # #   #   #
### ####### ### # # #
#       # # # #   # #
# ##### # ### ### ###
# #   #   # #       #
##### # # # ##### ###
#       #           #
##### ### # ####### #
#       # # #       #
#E###################