#S###################
# #     # # # #     #
# # ### # # # ### ###
#     #             #
# # ##### # ### # # #
# #   # # # #   # # #
####### ########### #
# #   #     #       #
# ### # # ######### #
# # #   #   # #   # #
# # # ##### # # ### #
#     #             #
#####E###############