#############S#######
#   #   #         # #
# ### # # ######### #
#     #             #
# # # ########### ###
# # #         # #   #
### # ######### ### #
#   #   # #       # #
# ####### # # # #####
#           # #     #
# ##### ### ### # ###
#   #     # #   #   #
#############E#######