#####################
# #           # #   S
# ### ######### # ###
#     # #       #   #
### # # ### ### # # #
#   #       # # # # #
# # # # # # # ##### #
E # # # # # # #   # #
######### ### ### # #
# #                 #
# # # ### ### ### # #
#   #   # #     # # #
#####################