###E#################
#   # #         #   #
### # # ### # # ### #
#       #   # #     #
# ### ##### ##### # #
# # # #   # #     # #
### ### ####### # ###
#       # # #   # # #
####### # # ##### # #
#           # #     #
### # ##### # ### # #
#   # #           # #
#S###################