#####E###############
#   # #         # # #
### # # # ##### # # #
#       # # #       #
########### ####### #
# # #     #         #
# # ### ##### # ### #
# #           #   # #
# ##### ### # ##### #
#         # #   #   #
### ### ##### # # # #
#   #     #   # # # #
#S###################