###############E#####
# #       # # #   # #
# ### ##### # ### # #
# #     #     #     #
# ### ####### ### # #
#         #     # # #
# ### # ##### # ### #
#   # #       # #   #
##### ######### # # #
# #   #         # # #
# # ##### # ### # ###
#     #   # #       #
#####S###############