###############S#####
#   #             # #
### # ### ######### #
#       #           #
### ##### ##### # ###
#     # #     # #   #
### ### ########### #
#   #     # #   # # #
### ### ### # ### ###
#     # #       # # #
# ##### # ### ### # #
#         #         #
###################E#